# ####################################
# ####################################
#           ##########            ####
##### ##### ############# ####### ####
##### ##### ############# ####### ####
###         #############  ###### ####
###### ### ####       ### ####### ####
### ## ### ####           ####### ####
### ## ### ####       ########### ####
### ## ### ###### ############### ####
###### ########## ############### ####
###### ########## ############### ####
######            ############### ####
####### ######################### ####
#######                           ####
######################################
